1111111111
1111111111
2222222222
2222222222
3333333333
3333333333
1111111111
1111111111
1111111111