0011110000
0111222200
1110023330
1100002220
0000033330
0000311000
0001110000
0011330000
0110000000
2221111122
2222333222